%%%%%%%%%%%%%%%%%%%%%%                                                 
%%%%%%%%%%%%%%%%%%%%%%                                                 
%%%%%%%%%%%%%%%%%%%%%%                                                 
%%%%%%%%%%%%%%%%%%%%%%                                                 
%%%%%%%%%%%%%%%%%%%%%%                                                 
%%%%%%%%%%%%%%%%%%%%%                                                  
%%%%%%%%%%%%%%%%%%%%%                                                  
%%%%%%%%%%%%%%%%%%%%%                                                  
%%%%%%%%%%%%%%%%%%%%%                                                  
%%%%%%%%%%%%%%%%%%%%%                                                  
%%%%%%%%%%%%%%%%%%%%%%                      %%%                        
%%%%%%%%%%%%%%%%%%%%%%%                  %%%%%%%                       
%%%%%%%%%%%%%%%%%%%%%%%%              %%%%%%%%%%                       
%%%%%%%%%%%%%%%%%%%%%%%%%%        %%%%%%%%%%%%%%                       
%%%%%%%%%%%%%%%%%%%%%%%%%%%%%%%%%%%%%%%%%%%%%%%%                       
%%%%%%%%%%%%%%%%%%%%%%%%%%%%%%%%%%%%%%%%%%%%%%%                        
%%%%%%%%%%%%%%%%%%%%%%%%%%%%%%%%%%%%%%%%%%%%%%%                        
%%%%%%%%%%%%%%%%%%%%%%%%%%%%%%%%%%%%%%%%%%%%%%                         
%%%%%%%%%%%%%%%%%%%%%%%%%%%%%%%%%%%%%%%%%%%%%                          
%%%%%%%%%%%%%%%%%%%%%%%%%%%%%%%%%%%%%%%%%%%                            
%%%%%%%%%%%%%%%%%%%%%%%%%%%%%%%%%%%%%%%%%%                   %%%%      
%%%%%%%%%%%%%%%%%%%%%%%%%%%%%%%%%%%%%%%%                    %%%%%      
%%%%%%%%%%%%%%%%%%%%%%%%%%%%%%%%%%%%%%                    %%%%%%%      
%%%%%%%%%%%%%%%%%%%%%%%%%%%%%%%%%%%%%                    %%%%%%%%      
%%%%%%%%%%%%%%%%%%%%%%%%%%%%%%%%%%%%                   %%%%%%%%%%      
%%%%%%%%%%%%%%%%%%%%%%%%%%%%%%%%%%                    %%%%%%%%%%       
%%%%%%%%%%%%%%%%%%%%%%%%%%%%%%%%%                    %%%%%%%%%%%       
%%%%%%%%%%%%%%%%%%%%%%%%%%%%%%%%       ..       %%% %%%%%%%%%%%        
%%%%%%%%%%%%%%%%%%%%%%%%%%%%%%%       ...      %%%%%%%%%%%%%%%         
%%%%%%%%%%%%%%%%%%%%%%%%%%%%%        ....     %%%%%%%%%%%%%%%%         
%%%%%%%%%%%%%%%%%%%%%%%%%%%%       %....     %%%%%%%%%%%%%%%%          
%%%%%%%%%%%%%%%%%%%%%%%%%%%        %....    %%%%%%%%%%%%%%%%           
%%%%%%%%%%%%%%%%%%%%%%%%%%%       %%...    %%%%%%%%%%%%%%%%            
%%%%%%%%%%%%%%%%%%%%%%%%%%       %%...    %%%%%%%%%%%%%%%%             
%%%%%%%%%%%%%%%%%%%%%%%%%       %%%..    %%%%%%%%%%%%%%%%              
%%%%%%%%%%%%%%%%%%%%%%%%       %%%%%%   %%%%%%%%%%%%%%%%               
%%%%%%%%%%%%%%%%%%%%%%%%      %%%%%%   %%%%%%%%%%%%%%%%                
%%%%%%%%%%%%%%%%%%%%%%%      %%%%%%    %%%%%%%%%%%%%%%%                
%%%%%%%%%%%%%%%%%%%%%%       %%%%%    %%%%%%%%%%%%%%%%                 
%%%%%%%%%%%%%%%%%%%%%%      %%%%%    %%%%%%%%%%%%%%%%                  
%%%%%%%%%%%%%%%%%%%%%%     %%%%%%    %%%%%%%%%%%%%%%                   
%%%%%%%%%%%%%%%%%%%%%      %%%%%    %%%%%%%%%%%%%%%%                   
%%%%%%%%%%%%%%%%%%%%%     %%%%%    %%%%%%%%%%%%%%%%                    
%%%%%%%%%%%%%%%%%%%%      %%%%%    %%%%%%%%%%%%%%%                     
%%%%%%%%%%%%%%%%%%%%     %%%%%    %%%%%%%%%%%%%%%%                     
%%%%%%%%%%%%%%%%%%%%    %%%%%%    %%%%%%%%%%%%%%%                      
%%%%%%%%%%%%%%%%%%%%    %%%%%    %%%%%%%%%%%%%%%%                      
%%%%%%%%%%%%%%%%%%%%   %%%%%     %%%%%%%%%%%%%%%                       
%%%%%%%%%%%%%%%%%%%%   %%%%%    %%%%%%%%%%%%%%%%                       
%%%%%%%%%%%%%%%%%%%%   %%%%     %%%%%%%%%%%%%%%                        
%%%%%%%%%%%%%%%%%%%%  %%%%%    %%%%%%%%%%%%%%%%                        
%%%%%%%%%%%%%%%%%%%%  %%%%     %%%%%%%%%%%%%%%                         
%%%%%%%%%%%%%%%%%%%% %%%%%    %%%%%%%%%%%%%%%%                         
%%%%%%%%%%%%%%%%%%%% %%%%     %%%%%%%%%%%%%%%%                         
%%%%%%%%%%%%%%%%%%% %%%%%    %%%%%%%%%%%%%%%%                          
%%%%%%%%%%%%%%%%%%% %%%%%    %%%%%%%%%%%%%%%%                          
%%%%%%%%%%%%%%%%%%% %%%%     %%%%%%%%%%%%%%%                           
%%%%%%%%%%%%%%%%%% %%%%%    %%%%%%%%%%%%%%%%                           
%%%%%%%%%%%%%%%%%% %%%%     %%%%%%%%%%%%%%%%                           
%%%%%%%%%%%%%%%%%% %%%%     %%%%%%%%%%%%%%%                            
%%%%%%%%%%%%%%%%%%%%%%%    %%%%%%% %%%%%%%%                            
%%%%%%%%%%%%%%%%%%%%%%     %%%%%%% %%%%%%%%                            
%%%%%%%%%%%%%%%%%%%%%%     %%%%%%  %%%%%%%%                            
%%%%%%%%%%%%%%%%%%%%%%    %%%%%%% %%%%%%%%                             
%%%%%%%%%%%%%%%%%%%%%     %%%%%%% %%%%%%%%                             
%%%%%%%%%%%%%%%%%%%%%     %%%%%%  %%%%%%%%                             
%%%%%%%%%%%%%%%%%%%%%    %%%%%%%  %%%%%%%                              
%%%%%%%%%%%%%%%%%%%%     %%%%%%% %%%%%%%%                              
%%%%%%%%%%%%%%%%%%%%     %%%%%%  %%%%%%%%                              
%%%%%%%%%%%%%%%%%%%%    %%%%%%%  %%%%%%%%                              
%%%%%%%%%%%%%%%%%%%     %%%%%%%  %%%%%%%                               
%%%%%%%%%%%%%%%%%%%     %%%%%%   %%%%%%%                               
%%%%%%%%%%%%%%%%%%%    %%%%%%%  %%%%%%%%                               
%%%%%%%%%%%%%%%%%%     %%%%%%%  %%%%%%%%                               
%%%%%%%%%%%%%%%%%%     %%%%%%   %%%%%%%                                
%%%%%%%%%%%%%%%%%%    %%%%%%%   %%%%%%%                                
%%%%%%%%%%%%%%%%%%    %%%%%%%   %%%%%%%                                
%%%%%%%%%%%%%%%%%     %%%%%%   %%%%%%%%                                
%%%%%%%%%%%%%%%%%    %%%%%%%   %%%%%%%%                                
%%%%%%%%%%%%%%%%%    %%%%%%%   %%%%%%%                                 
%%%%%%%%%%%%%%%%%    %%%%%%    %%%%%%%                                 
%%%%%%%% %%%%%%%%   %%%%%%%   %%%%%%%%                                 
%%%%%%%  %%%%%%%%   %%%%%%%   %%%%%%%%                                 
%%%%%%%  %%%%%%%%   %%%%%%    %%%%%%%%                                 
%%%%%%   %%%%%%%%  %%%%%%%    %%%%%%%                                  
%%%%%%   %%%%%%%%  %%%%%%%   %%%%%%%%                                  
%%%%%    %%%%%%%%  %%%%%%    %%%%%%%%                                  
%%%%     %%%%%%%% %%%%%%%    %%%%%%%%                                  
%%%%    %%%%%%%%% %%%%%%%   %%%%%%%%                                   
%%%     %%%%%%%%%%%%%%%%    %%%%%%%%                                   
%%%     %%%%%%%%%%%%%%%%    %%%%%%%%                                   
%%      %%%%%%%%%%%%%%%%    %%%%%%%%                                   
%       %%%%%%%%%%%%%%%    %%%%%%%%%                                   
        %%%%%%%%%%%%%%%    %%%%%%%%                                    
       %%%%%%%%%%%%%%%%    %%%%%%%%                                    
       %%%%%%%%%%%%%%%    %%%%%%%%%                                    
       %%%%%%%%%%%%%%%    %%%%%%%%%                                    
      %%%%%%%%%%%%%%%    %%%%%%%%%                                     
      %%%%%%%%%%%%%%%    %%%%%%%%%                                     
     %%%%%%%%%%%%%%%%    %%%%%%%%%                                    %
     %%%%%%%%%%%%%%%    %%%%%%%%%%                                    %
    %%%%%%%%%%%%%%%%    %%%%%%%%%                                    %%
    %%%%%%%%%%%%%%%    %%%%%%%%%%                                    %%
   %%%%%%%%%%%%%%%%    %%%%%%%%%%                                   %%%
   %%%%%%%%%%%%%%%    %%%%%%%%%%                                    %%%
  %%%%%%%%%%%%%%%%  P %%%%%%%%%%                                   %%%%
  %%%%%%%%%%%%%%%    %%%%%%%%%%%                                   %%%%
 %%%%%%%%%%%%%%%%    %%%%%%%%%%                                   %%%%%
%%%%%%%%%%%%%%%%%   %%%%%%%%%%%                                   %%%%%
%%%%%%%%%%%%%%%%%  %%%%%%%%%%%                                   %%%%%%
%%%%%%%%%%%%%%%%%  %%%%%%%%%%%                                   %%%%%%
%%%%%%%%%%%%%%%%% %%%%%%%%%%%                                   %%%%%%%
%%% %%%%%%%%%%%%%%%%%%%%%%%%%                                   %%%%%%%
%% %%%%%%%%%%%%%%%%%%%%%%%%%                                   %%%%%%%%
%%%%%%%%%%%%%%%%%%%%%%%%%%%%                                   %%%%%%%%
% %%%%%%%%%%%%%%%%%%%%%%%%%                                   %%%%%%%%%
 %%%%%%%%%%%%%%%%%%%%%%%%%                                    %%%%%%%%%
%%%%%%%%%%%%%%%%%%%%%%%%%                                    %%%%%%%%%%
%%%%%%%%%%%%%%%%%%%%%%%%                                     %%%%%%%%%%
%%%%%%%%%%%%%%%%%%%%%%%%                                    %%%%%%%%%%%
%%%%%%%%%%%%%%%%%%%%%%%                                     %%%%%%%%%%%
%%%%%%%%%%%%%%%%%%%%%%                                      %%%%%%%%%%%
%%%%%%%%%%%%%%%%%%%%                                       %%%%%%%%%%%%
%%%%%%%%%%%%%%%%%%%                                        %%%%%%%%%%%%
%%%%%%%%%%%%%%%%%%                                        %%%%%%%%%%%%%
%%%%%%%%%%%%%%%%%                                         %%%%%%%%%%%%%
%%%%%%%%%%%%%%%%%                                        %%%%%%%%%%%%%%
%%%%%%%%%%%%%%%%%                                        %%%%%%%%%%%%%%
%%%%%%%%%%%%%%%%%                                       %%%%%%%%%%%%%%%
%%%%%%%%%%%%%%%%%                                       %%%%%%%%%%%%%%%
%%%%%%%%%%%%%%%%%                                       %%%%%%%%%%%%%%%
%%%%%%%%%%%%%%%%%                                      %%%%%%%%%%%%%%%%
%%%%%%%%%%%%%%%%%                                      %%%%%%%%%%%%%%%%
%%%%%%%%%%%%%%%%%                                     %%%%%%%%%%%%%%%%%
%%%%%%%%%%%%%%%%%                                     %%%%%%%%%%%%%%%%%
%%%%%%%%%%%%%%%%%                                    %%%%%%%%%%%%%%%%%%
%%%%%%%%%%%%%%%%%                                    %%%%%%%%%%%%%%%%%%
%%%%%%%%%%%%%%%%%                                    %%%%%%%%%%%%%%%%%%
  %%%%%%%%%%%%%%%                                   %%%%%%%%%%%%%%%%%%%
   %%%%%%%%%%%%%%                                   %%%%%%%%%%%%%%%%%%%
    %%%%%%%%%%%%%                                  %%%%%%%%%%%%%%%%%%%%
     %%%%%%%%%%%%                                  %%%%%%%%%%%%%%%%%%%%
     %%%%%%%%%%%%                                  %%%%%%%%%%%%%%%%%%%%
      %%%%%%%%%%%                                 %%%%%%%%%%%%%%%%%%%%%
      %%%%%%%%%%%                                 %%%%%%%%%%%%%%%%%%%%%
      %%%%%%%%%%%                                 %%%%%%%%%%%%%%%%%%%%%
       %%%%%%%%%%                                %%%%%%%%%%%%%%%%%%%%%%
       %%%%%%%%%%                                %%%%%%%%%%%%%%%%%%%%%%
       %%%%%%%%%%                                %%%%%%%%%%%%%%%%%%%%%%
       %%%%%%%%%%                                %%%%%%%%%%%%%%%%%%%%%%
       %%%%%%%%%%                                %%%%%%%%%%%%%%%%%%%%%%
